%%%%%%%%%%%%%%%%%%%%
%................P %
% %% %% %% %% %% % %
% %% %    .      % %
%%%%%%%%%%%%%%%%%%%%
