%%%%%%%%%%%%%%%%%%%%
%...............P .%
% %% %% %% %% %% %.%
% %% %    .      %.%
%%%%%%%%%%%%%%%%%%%%
